11111111111111111111111111111111111111111111111111
10000000100000000000000000000000000000010000000001
10000000100000000000000000000000000000010000000001
10000000100000000000000000000000000000010000000001
10000000100000000000000000000000000000010000000001
10000000100000000000000000000000000000010000000001
10000000100000000000000000000000000000000000000001
10000000100000000000000000000000000000010000000001
11111111111111101111111111111111000111110000000001
10000000000000000000000000100000000000010000000001
10000000000000000000000000100000000000010000000001
10000000000000000000000000100000000000010000000001
10000000000000000000000000100000000000010000000001
10000000000000000000000000100000000000010000000001
10000000000000000000000000100000000000010000000001
10000000000000000000000000100000000000010000000001
10000000000000000000000000100000000000010000000001
10000000000000000000000000100000000000011111111111
10000000000000000000000000100000000000010000000001
10000000000000000000000000100000000000010000000001
10000000000000000000000000100000000000010000000001
10000000000000000000000000000000000000010000000001
10000000000000000000000000100000000000010000000001
10000000000000000000000000100000000000010000000001
10000000000000000000000000100000000000000000000001
100000000000000000000000001000000N0000010000000001
11111111111111111111111111111111111111111111111111
