11111        111111111
10001        101000001
10001        101000001
10001        101000001
1000111111111101000001
1000100000000001000001
100000000000000D000001
1000100000000001000001
11111111D1111011000001
1000000000010001000001
1000000000010001000001
1000000000010001000001
1000000000010001000001
1000000000010001000001
1000000000010001000001
1000000000010001000001
1000000000010001111111
1000000000010001000001
10000000000D0001000001
100000000001000D000001
100000000001N001000001
1111111111111111111111
