     111111111111  11111111111111
     100000000001  1T0000000000T1
     101111111101111000000X000001
     10000T10000000D000B000000001
111111111010B0001111T0000000000T1
1T000000001000001111111111D111111
1T00000000X000011BT0T0TTT001
1111D111111111111B0X000B0001
110000001101T1111B0000000001
1000000000000X00000000000001
10000000T0000X00000000000001
1100000111010101111100000N01
 1110111 1110101   111100001
   111    111111      111111
