        1111111111111111111111111
        1000000000110000000000001
        1011000001110000000000001
        1001000000000000000000001
111111111011000001110000000000001
100000000011000001110111110111111
1111011111111101110000000001
1111011111111101110T00000T01
110000001101T101110000000001
1000000000000000000000000001
10000000T0000000000000000001
1100000111010101111100000N01
 1110111 1110101   111100001
   111    111111      111111
