NO ./assets/textures/wood2.xpm
SO ./assets/textures/wood2.xpm
WE ./assets/textures/wood2.xpm
EA ./assets/textures/wood2.xpm


111111111111111111111111111111
1E0000000000000000000000000001
11111111111111111111111D111101
1000000000000D0000000000100101
10111111111111D111111110100101
101000000000000000D00010100101
101011111111111111111010000101
101111100000000D00001011111111
100011111111101111101000000001
101000000D00001000001110111101
101111111111101111110000D00001
100010000D00000000000111111101
111111111111111111111111111111
