          111111111111111111111111111111111      111111
     111111X0000000000000000100000000000001      1X0XX1
     1X0XX100000011111111111100000000000001      1XX111
111111000X110000010000100100100001000100001      1001
10XX010000110000010000000000D00001000100001      1001
1000010000010000011000100100100011000110001      1001
10000111110111110100011111111000000000000011111111001111
1000010XX000X00101100100000010000000000000100001000000011111
10000000010X00000001110001111111111D11111110000D000000000001
100000000D0001000001000000011111110001    1000011111100011111
1000000001000000000D00000001000111000111111111110000000000001
1000000001000000000100000001100011000D00000000000000000000001
1111111111000000000101111110000011000111111111110000000000001
10001100000000011111011100001111110001         10000000000001
1000111111D111110011010000011    1000111       10000001010001
1000100010001001100101001001     10000]1       10000001010001
11D1100010001000100101000001     1000111111111111100011010001
1000111110001100100101001001     100010X0000000100000010100011
10001   10001001100101011101     10001000000001111000000000001
10001   10001000110101010001     10001000000000000000000000001
10001   100010000101010101111111110001111111111111111001000001
1000111111D111110101010101000001111D111    100001000001111111111
1000110000000001000101010001111110000011111100001000001000000001
100011100000000100000100000100000000000000010000000000D000000001
1000110000000001]00000000001000100000001000111111111111100000001
1000011001110001111100000111000000000000000010000000001000000001
10000D0X0000000100000000000D0000000000000000D000000000D000100001
1000011001110011000000000001000X00000000000010000000001000000001
1000110000000001000011111111001110000011100111100001111000000001
1000111000000011000000000001000000000000000110110011001000000001
1000110000000001111000000001111111000111111110010010000000000001
1000111111D111110000001111111001111D111111110001001000111]110111
10001000100010011111000000000001010010000000001001000001111111
100011111000111111111111111111111100101111111010010000X0X0001
10001   10000D0000000000000000000D00D0000000001001011111D1111
10001   1000111111111111111111111100100011100X11D111010101011
10001   10001001111111111111111111001111111111100010000000001
100011111000100000000000000001   1001         1000D0X00000001
100011111000100111111111110001   1001111111111100010000000001
100000001000111111000000110001   100100X011111101010010101111
10000000000000000D000000110001   100100001X000000011D11111
111000110000000001000000110001   100110001111000000001
1111D1111111111111D11111111D11   1001X000X000000000001
100000000001    10001   10001111111D111111111111111111
100000000001    111111111000111111000111111
100000000001       1X000000011000D000D00001
1000000000011111111110011111110001000100001
10000000000010010000000000011X0001000100001
10000000000011010000000000011111D10001D1111
100000000000111100000000000X100001000100001
1000000000000000000000000001100001000100001
1100000000000000000000000001100001000100001
 100000000000000000000000001100001000100001
 100000000000000000000011111100000000000001
 10000000000000000000001    100000000000001
 11000000000000000000111    100000000000001
  11111111111111111111      111111111111111
