NO ./assets/textures/crackedstone.xpm
SO ./assets/textures/def_stone.xpm
WE ./assets/textures/paved.xpm
EA ./assets/textures/jgl_stone.xpm

111111111111111
100000000000001
100000000000001111111111
10000E00000000D000000001
100000000000001111111101
100000000000001      101
1111111111111D1      1D1
        1111101111111101111111111
        1000000000110000000000001
        1011000001110000000000001
        1001000000000000000000001
111111111D11000001110000000000001
10000000001100000111011111D111111
11110111111111011100000010001
11110111111111011101010010001
11000000110101011100000010001
10000000000000001100000010001
10000000000000001101010010001
11000001110101011111011110001
11111111111101010111D110100011111111
100000000000000000000000000000000001
100000000000000000000000000000000001
11111D11D111111111111111111111111111
1000000100011
10010001000011
10010001000001
11000000000011
1110000000011
100000000011
10000000001
10000000001111 111111111111     111111
111101111D110111011001000011111110110111
1000000000000000000000000000000000000001
1111011111111000000100001111111111000111
10000000000000100000000010000000000111
1111111111111111100000111011110111110111
                100000000000000000000011
                110001111110011111011001
                 10011    11000001000101
              1111D11     11000100010001
   11111111111100001    1110010000111111
   10000000000000111111110111100001
   10110111111001111000000011100001
   100001   10000000010000000001111
   111111   11111111111111111111
